1	0	3	3	2
1	1	3	0	1
1	0	3	1	1
3	3	3	0	1
4	1	1	1	1